11111111111111111111111111111
1E00000000000C000000000000001
10010100100000001000000010101
10110010101001001000000010101
1000000C00000000000000P0000C1
11111111111111111111111111111