11111111111
100P0000001
10000000001
10000000001
10000000001
10000000001
11111111111